###########                ##############
#.........#                #..$.........#          ###############
#.........##################............############..........%..#
#.......................................*........................#
#.........#########.########............#########.################
#.........#       #.#      #.........(..#       #.#       ############
###########       #.#      ##############       #.#       #.......(..#
                  #.#                           #.#       #..........#
                  #.#                           #.#       #..........#
                  #.#                           #.#       #..........#
                  #.#                           #.#########.........$#
       ############.#####                       #....................#
       #..%.............#        ############## #############........################################
       #................#        #..........&.#            #.........*..............................*
       #............$...#        #............##############.........################################
       ##################        #...$.....................^.........#
                                 #####################################