new []{3,3,3,3,3,3,3,3,3,3,3,3,3,3,3,3,3,3,3,3,3,3,3,3,3,3,3,3,3,3,3,3,3,3,3,3,3,3,3,3,3,3,3,3,3,3,3,3,3,3,3,3,3,3,3,3,3,3,3,3,3,3,3,3,3,3,3,3,3,3,3,3,3,3,3,3,3,3,3,3,3,3,3,},
new []{3,3,3,3,3,3,3,3,3,3,3,3,3,3,3,3,3,3,3,3,3,3,3,3,3,3,3,3,3,3,3,3,3,3,3,3,3,3,3,3,3,3,3,3,3,3,3,3,3,3,3,3,3,3,3,3,3,3,3,3,3,3,3,3,3,3,3,3,3,3,3,3,3,3,3,3,3,3,3,3,3,3,3,},
new []{3,3,3,3,3,3,3,3,5,4,4,4,4,4,4,4,4,4,4,4,4,5,3,3,3,3,3,3,3,3,3,3,3,3,3,3,3,3,3,5,4,4,4,5,3,3,3,3,3,3,3,3,3,3,3,3,3,3,3,3,3,5,4,4,4,4,4,4,4,4,4,4,4,4,5,3,3,3,3,3,3,3,3,},
new []{3,3,3,3,3,3,3,3,2,0,0,0,0,0,0,0,0,0,0,0,0,2,3,3,3,3,3,3,3,3,3,3,3,3,3,3,3,5,4,5,1,1,1,5,4,5,3,3,3,3,3,3,3,3,3,3,3,3,3,3,3,2,0,0,0,0,0,0,0,0,0,0,0,0,2,3,3,3,3,3,3,3,3,},
new []{3,3,3,3,3,3,3,3,2,0,0,0,0,1,1,1,1,1,0,0,0,2,3,3,3,3,3,3,3,3,3,3,3,3,3,5,4,5,1,1,1,1,1,1,1,5,4,5,3,3,3,3,3,3,3,3,3,3,3,3,3,2,0,0,0,1,1,1,1,1,0,0,0,0,2,3,3,3,3,3,3,3,3,},
new []{3,3,3,3,3,3,3,3,2,0,0,0,1,1,1,1,1,1,1,0,0,2,3,3,3,3,3,3,3,3,3,3,3,5,4,5,1,1,1,1,1,1,1,1,1,1,1,5,4,5,3,3,3,3,3,3,3,3,3,3,3,2,0,0,1,1,1,1,1,1,1,0,0,0,2,3,3,3,3,3,3,3,3,},
new []{3,3,3,3,3,3,3,3,2,0,0,1,1,1,1,1,1,1,1,1,0,2,3,3,3,3,3,3,3,3,3,3,3,2,1,1,1,1,1,1,1,1,1,1,1,1,1,1,1,2,3,3,3,3,3,3,3,3,3,3,3,2,0,1,1,1,1,1,1,1,1,1,0,0,2,3,3,3,3,3,3,3,3,},
new []{3,3,3,3,3,3,3,3,2,0,1,1,1,1,1,9,9,9,1,1,1,2,3,3,3,3,3,3,3,3,3,3,3,2,1,1,1,1,1,1,13,12,14,1,1,1,1,1,1,2,3,3,3,3,3,3,3,3,3,3,3,2,1,1,1,1,1,1,1,1,1,1,1,0,2,3,3,3,3,3,3,3,3,},
new []{3,3,3,3,3,3,3,3,2,0,1,1,1,1,1,1,1,1,1,1,1,2,3,3,3,3,3,3,3,3,3,3,3,2,1,1,1,1,9,1,1,1,1,1,9,1,1,1,1,2,3,3,3,3,3,3,3,3,3,3,3,2,1,1,1,1,1,1,1,1,1,1,1,0,2,3,3,3,3,3,3,3,3,},
new []{3,3,3,3,3,3,3,3,2,1,1,1,1,1,1,1,1,1,1,1,1,2,3,3,3,3,3,3,3,3,3,3,3,2,1,1,1,1,1,1,1,1,1,1,1,1,1,1,1,2,3,3,3,3,3,3,3,3,3,3,3,2,1,1,1,1,1,1,1,1,1,1,1,1,2,3,3,3,3,3,3,3,3,},
new []{3,3,3,3,3,3,3,3,2,1,1,1,1,1,1,1,1,1,1,1,1,2,3,3,3,3,3,3,3,3,3,3,3,2,1,1,1,1,9,1,1,1,1,1,9,1,1,1,1,2,3,3,3,3,3,3,3,3,3,3,3,2,1,1,1,1,1,1,1,1,1,1,1,1,2,3,3,3,3,3,3,3,3,},
new []{3,3,3,3,3,3,3,3,2,1,1,1,1,1,1,1,1,1,1,1,1,2,3,3,3,3,3,3,3,3,3,3,3,2,1,1,1,1,1,1,1,1,1,1,1,1,1,1,1,2,3,3,3,3,3,3,3,3,3,3,3,2,1,1,1,1,1,1,1,1,1,1,1,1,2,3,3,3,3,3,3,3,3,},
new []{3,3,3,3,3,3,3,3,5,4,4,4,4,4,5,1,1,5,4,4,4,5,3,3,3,3,3,3,3,3,3,3,3,2,1,1,1,1,9,1,1,1,1,1,9,1,1,1,1,2,3,3,3,3,3,3,3,3,3,3,3,5,4,4,4,4,5,1,1,5,4,4,4,4,5,3,3,3,3,3,3,3,3,},
new []{3,3,3,3,3,3,3,3,3,3,3,3,3,3,2,1,1,2,3,3,3,3,3,3,3,3,3,3,3,3,3,3,3,5,4,4,4,4,4,4,1,1,1,4,4,4,4,4,4,5,3,3,3,3,3,3,3,3,3,3,3,3,3,3,3,3,2,1,1,2,3,3,3,3,3,3,3,3,3,3,3,3,3,},
new []{3,3,3,3,3,3,3,3,3,3,3,3,3,3,2,1,1,2,3,3,3,3,3,3,3,3,3,3,3,3,3,3,3,3,3,3,3,3,3,2,1,1,1,2,3,3,3,3,3,3,3,3,3,3,3,3,3,3,3,3,3,3,3,3,3,3,2,1,1,2,3,3,3,3,3,3,3,3,3,3,3,3,3,},
new []{3,3,3,3,3,3,3,3,3,3,3,3,3,3,2,1,1,2,3,3,3,3,3,3,3,3,3,3,3,3,3,3,3,3,3,3,3,3,3,2,1,1,1,2,3,3,3,3,3,3,3,3,3,3,3,3,3,3,3,3,3,3,3,3,3,3,2,1,1,2,3,3,3,3,3,3,3,3,3,3,3,3,3,},
new []{3,3,3,3,3,3,3,3,3,3,3,3,3,3,2,1,1,2,3,3,3,3,3,3,3,3,3,3,3,3,3,3,3,3,3,3,3,3,3,2,1,1,1,2,3,3,3,3,3,3,3,3,3,3,3,3,3,3,3,3,3,3,3,3,3,3,2,1,1,2,3,3,3,3,3,3,3,3,3,3,3,3,3,},
new []{3,3,3,3,3,3,3,3,3,3,3,3,3,3,2,1,1,2,3,3,3,3,3,3,3,3,3,3,3,3,3,3,3,3,3,3,3,3,3,2,1,1,1,2,3,3,3,3,3,3,3,3,3,3,3,3,3,3,3,3,3,3,3,3,3,3,2,1,1,2,3,3,3,3,3,3,3,3,3,3,3,3,3,},
new []{3,3,3,3,3,3,3,3,3,3,3,3,3,3,2,1,1,2,3,3,3,3,3,3,3,3,3,3,3,3,3,3,3,3,3,3,3,3,3,2,1,1,1,2,3,3,3,3,3,3,3,3,3,3,3,3,3,3,3,3,3,3,3,3,3,3,2,1,1,2,3,3,3,3,3,3,3,3,3,3,3,3,3,},
new []{3,3,3,3,3,3,3,3,3,3,3,3,3,3,2,1,1,2,3,3,3,3,3,3,3,3,3,3,3,3,3,3,3,3,3,3,3,3,3,2,1,1,1,2,3,3,3,3,3,3,3,3,3,3,3,3,3,3,3,3,3,3,3,3,3,3,2,1,1,2,3,3,3,3,3,3,3,3,3,3,3,3,3,},
new []{3,3,3,3,3,3,3,3,3,3,3,3,3,3,2,1,1,2,3,3,3,3,3,3,3,3,3,3,3,3,3,3,5,4,4,4,4,4,4,4,1,1,1,4,4,4,4,4,4,4,5,3,3,3,3,3,3,3,3,3,3,3,3,3,3,3,2,1,1,2,3,3,3,3,3,3,3,3,3,3,3,3,3,},
new []{3,3,3,3,3,3,3,3,3,3,3,3,3,3,2,1,1,2,3,3,3,3,3,3,3,3,3,3,3,3,3,3,2,1,1,1,1,1,1,1,1,1,1,1,1,1,1,1,1,1,2,3,3,3,3,3,3,3,3,3,3,3,3,3,3,3,2,1,1,2,3,3,3,3,3,3,3,3,3,3,3,3,3,},
new []{3,3,3,3,3,3,3,3,3,3,5,4,4,4,5,1,1,5,4,4,4,4,4,4,5,3,3,3,3,3,3,3,2,1,1,1,9,1,1,1,1,1,1,1,1,1,9,1,1,1,2,3,3,3,3,3,3,3,5,4,4,4,4,4,4,4,1,1,1,4,4,4,5,3,3,3,3,3,3,3,3,3,3,},
new []{3,3,3,3,3,3,3,3,3,3,2,6,6,6,6,1,1,7,7,7,7,7,7,7,2,3,3,3,3,3,3,3,2,1,1,1,1,1,1,1,1,1,1,1,1,1,1,1,1,1,2,3,3,3,3,3,3,3,2,6,6,6,6,6,6,6,1,1,1,6,6,6,2,3,3,3,3,3,3,3,3,3,3,},
new []{3,3,3,3,3,3,3,3,3,3,2,6,6,6,1,1,1,1,7,7,7,7,7,7,2,3,3,3,3,3,3,3,2,1,1,9,1,1,1,1,1,1,1,1,1,1,1,9,1,1,2,3,3,3,3,3,3,3,2,6,6,6,6,6,6,6,6,1,1,1,6,6,2,3,3,3,3,3,3,3,3,3,3,},
new []{3,3,3,3,3,3,3,3,3,3,2,6,6,6,1,1,1,1,1,1,7,7,7,7,2,3,3,3,3,3,3,3,2,1,1,1,1,1,1,1,1,1,1,1,1,1,1,1,1,1,2,3,3,3,3,3,3,3,2,6,6,6,6,6,6,6,6,1,1,1,6,6,2,3,3,3,3,3,3,3,3,3,3,},
new []{3,3,3,3,3,3,3,3,3,3,2,6,6,6,9,1,1,1,1,1,1,1,1,1,2,3,3,3,3,3,3,3,2,1,9,1,1,1,1,1,1,1,1,1,1,1,1,1,9,1,2,3,3,3,3,3,3,3,2,6,6,6,6,6,6,6,6,1,1,1,1,6,2,3,3,3,3,3,3,3,3,3,3,},
new []{3,3,3,3,3,3,3,3,3,3,2,6,6,6,6,1,1,1,1,1,1,9,1,1,2,3,3,3,3,3,3,3,2,1,1,1,1,1,1,1,1,1,1,1,1,1,1,1,1,1,2,3,3,3,3,3,3,3,2,6,6,6,6,6,6,6,6,1,1,1,1,6,2,3,3,3,3,3,3,3,3,3,3,},
new []{3,3,3,3,3,3,3,3,3,3,2,6,6,6,6,1,1,1,1,1,1,1,1,1,2,3,3,3,3,3,3,3,2,1,1,1,1,1,1,11,11,11,11,1,1,1,1,1,1,1,2,3,3,3,3,3,3,3,2,6,6,6,6,6,6,6,1,1,1,1,9,1,2,3,3,3,3,3,3,3,3,3,3,},
new []{3,3,3,3,3,3,3,3,3,3,2,6,6,6,6,6,6,6,1,1,1,1,1,1,5,4,4,4,4,4,4,4,5,1,1,1,1,1,1,11,12,12,11,1,1,1,1,1,1,1,5,4,4,4,4,4,4,4,5,6,6,6,6,6,6,1,1,1,1,1,1,1,2,3,3,3,3,3,3,3,3,3,3,},
new []{3,3,3,3,3,3,3,3,3,3,2,6,6,6,6,6,6,6,6,6,6,1,1,1,1,1,1,1,1,1,1,1,1,1,1,1,1,1,1,11,12,12,11,1,1,1,1,1,1,1,1,1,1,1,1,1,1,1,1,1,6,6,6,6,1,1,1,1,1,1,1,6,2,3,3,3,3,3,3,3,3,3,3,},
new []{3,3,3,3,3,3,3,3,3,3,2,6,6,6,6,6,6,6,6,6,6,6,6,1,1,1,1,1,1,1,1,1,1,1,1,1,1,1,1,11,11,11,11,1,1,1,1,1,1,1,1,1,1,1,1,1,1,1,1,1,1,1,1,1,1,1,1,1,1,1,6,6,2,3,3,3,3,3,3,3,3,3,3,},
new []{3,3,3,3,3,3,3,3,3,3,2,6,6,6,6,6,6,6,6,6,6,6,6,6,5,4,4,4,4,4,4,4,5,1,1,1,1,1,1,1,1,1,1,1,1,1,1,1,1,1,5,4,4,4,4,4,4,4,5,1,1,1,1,1,1,1,1,1,1,6,6,6,2,3,3,3,3,3,3,3,3,3,3,},
new []{3,3,3,3,3,3,3,3,3,3,2,6,6,6,6,6,6,6,6,6,6,6,6,6,2,3,3,3,3,3,3,3,2,1,1,1,1,1,1,1,1,1,1,1,1,1,1,1,1,1,2,3,3,3,3,3,3,3,2,6,1,1,1,1,1,1,1,6,6,6,6,6,2,3,3,3,3,3,3,3,3,3,3,},
new []{3,3,3,3,3,3,3,3,3,3,2,6,6,6,6,6,6,6,6,6,6,6,6,6,2,3,3,3,3,3,3,3,2,1,9,1,1,1,1,1,1,1,1,1,1,1,1,1,9,1,2,3,3,3,3,3,3,3,2,6,6,9,1,1,6,6,6,8,8,8,8,8,2,3,3,3,3,3,3,3,3,3,3,},
new []{3,3,3,3,3,3,3,3,3,3,2,6,6,6,6,6,6,6,6,6,6,6,6,6,2,3,3,3,3,3,3,3,2,1,1,1,1,1,1,1,1,1,1,1,1,1,1,1,1,1,2,3,3,3,3,3,3,3,2,6,6,6,6,6,6,6,8,8,8,8,8,8,2,3,3,3,3,3,3,3,3,3,3,},
new []{3,3,3,3,3,3,3,3,3,3,2,6,6,6,6,6,6,6,6,6,6,6,6,6,2,3,3,3,3,3,3,3,2,1,1,9,1,1,1,1,1,1,1,1,1,1,1,9,1,1,2,3,3,3,3,3,3,3,2,6,6,6,6,6,6,8,8,8,8,8,8,8,2,3,3,3,3,3,3,3,3,3,3,},
new []{3,3,3,3,3,3,3,3,3,3,5,4,4,4,4,4,4,4,4,4,4,4,4,4,5,3,3,3,3,3,3,3,2,1,1,1,1,1,1,1,1,1,1,1,1,1,1,1,1,1,2,3,3,3,3,3,3,3,5,4,4,4,4,4,4,4,4,4,4,4,4,4,5,3,3,3,3,3,3,3,3,3,3,},
new []{3,3,3,3,3,3,3,3,3,3,3,3,3,3,3,3,3,3,3,3,3,3,3,3,3,3,3,3,3,3,3,3,2,1,1,1,9,1,1,1,1,1,1,1,1,1,9,1,1,1,2,3,3,3,3,3,3,3,3,3,3,3,3,3,3,3,3,3,3,3,3,3,3,3,3,3,3,3,3,3,3,3,3,},
new []{3,3,3,3,3,3,3,3,3,3,3,3,3,3,3,3,3,3,3,3,3,3,3,3,3,3,3,3,3,3,3,3,2,1,1,1,1,1,1,1,1,1,1,1,1,1,1,1,1,1,2,3,3,3,3,3,3,3,3,3,3,3,3,3,3,3,3,3,3,3,3,3,3,3,3,3,3,3,3,3,3,3,3,},
new []{3,3,3,3,3,3,3,3,3,3,3,3,3,3,3,3,3,3,3,3,3,3,3,3,3,3,3,3,3,3,3,3,5,4,4,4,4,4,4,5,1,1,1,5,4,4,4,4,4,4,5,3,3,3,3,3,3,3,3,3,3,3,3,3,3,3,3,3,3,3,3,3,3,3,3,3,3,3,3,3,3,3,3,},
new []{3,3,3,3,3,3,3,3,3,3,3,3,3,3,3,3,3,3,3,3,3,3,3,3,3,3,3,3,3,3,3,3,3,3,3,3,3,3,3,2,1,1,1,2,3,3,3,3,3,3,3,3,3,3,3,3,3,3,3,3,3,3,3,3,3,3,3,3,3,3,3,3,3,3,3,3,3,3,3,3,3,3,3,},
new []{3,3,3,3,3,3,3,3,3,3,3,3,3,3,3,3,3,3,3,3,3,3,3,3,3,3,3,3,3,3,3,3,3,3,3,3,3,3,3,2,1,1,1,2,3,3,3,3,3,3,3,3,3,3,3,3,3,3,3,3,3,3,3,3,3,3,3,3,3,3,3,3,3,3,3,3,3,3,3,3,3,3,3,},
new []{3,3,3,3,3,3,3,3,3,3,3,3,3,3,3,3,3,3,3,3,3,3,3,3,3,3,3,3,3,3,3,3,3,3,3,3,3,3,3,2,1,1,1,2,3,3,3,3,3,3,3,3,3,3,3,3,3,3,3,3,3,3,3,3,3,3,3,3,3,3,3,3,3,3,3,3,3,3,3,3,3,3,3,},
new []{3,3,3,3,3,3,3,3,3,3,3,3,3,3,3,3,3,3,3,3,3,3,3,3,3,3,3,3,3,3,3,3,3,3,3,3,3,3,3,2,1,1,1,2,3,3,3,3,3,3,3,3,3,3,3,3,3,3,3,3,3,3,3,3,3,3,3,3,3,3,3,3,3,3,3,3,3,3,3,3,3,3,3,},
new []{3,3,3,3,3,3,3,3,3,3,3,3,3,3,3,3,3,3,3,3,3,3,3,3,3,3,3,3,3,3,3,3,3,3,3,3,3,3,3,2,1,1,1,2,3,3,3,3,3,3,3,3,3,3,3,3,3,3,3,3,3,3,3,3,3,3,3,3,3,3,3,3,3,3,3,3,3,3,3,3,3,3,3,},
new []{3,3,3,3,3,3,3,3,3,3,3,3,3,3,3,3,3,3,3,3,3,3,3,3,3,3,3,3,3,3,3,3,3,3,3,3,3,3,3,2,1,1,1,2,3,3,3,3,3,3,3,3,3,3,3,3,3,3,3,3,3,3,3,3,3,3,3,3,3,3,3,3,3,3,3,3,3,3,3,3,3,3,3,},
new []{3,3,3,3,3,3,3,3,3,3,3,3,3,3,3,3,3,3,3,3,3,3,3,3,3,3,3,3,3,3,3,3,3,3,3,3,3,3,3,5,10,10,10,5,3,3,3,3,3,3,3,3,3,3,3,3,3,3,3,3,3,3,3,3,3,3,3,3,3,3,3,3,3,3,3,3,3,3,3,3,3,3,3,},